1111111111111111111111
1E0000000000000C000C01
1010010100100000101101
1010010010101010001001
1P0000000C00C000001C01
1111111111111111111111