1111111111111111111111111111111
100000000000001000C00100000C001
1010010100100010101001000000001
1011110010101010001001000000C01
1P000000000000000000110C0000001
1111111111111111110011011111111
1C0000000000000000000000000CC11
11111100000C0011000000001100011
1E000000C0111000000011100000011
1111111111111111111111111111111