1111111111111
1CCCCCCCCCCC1
1C001000100C1
1C001000100C1
1C000000000C1
1C010000010C1
1C011000110C1
1C001111100C1
1P000000000E1
1111111111111