11111111
100000E1
11111111
1P0C0101
11111111